###########
#S...#....#
#.###.#.###
#...#.#..##
#.#.#.#.###
#.#.#.#..##
#.#.#.#.###
#.#.#.#..##
#....#...##
#...#...E##
###########