##############
#S........####
###.#......###
#...#.#.#.#.##
#.#.#.#.#.#.##
#.#.#.#.#.#.##
#.#.#.#.#.#.##
#...#......###
###.########E#
##############
