###########
#S .  .  .  .  .  .  . ###
### . # .  .  .  .  . ###
# .  .  . # . # . # . # . #
# . # . # . # . # . # . #
# . # . # . # . # . # . #
# . # . # . # . # . # . #
# .  .  . # .  .  .  .  .  . #
### . ###E########
###########
