#############
#S .  .  .  .  .  .  .  .  #
### . # .  .  .  .  .  . ###
# .  .  . # . # . # . # . #
# . # . # . # . # . # . #
# . # . # . # . # . # . #
# . # . # . # . # . # . #
# .  .  . # .  .  .  .  .  . #
### . ########E#
#############
