###########
#S......###
###.##.####
#...#.#.#.#
#.#.#.#.#.#
#.#.#.#.#.#
#.#.#.#.#.#
#...#.....#
###E#######
###########