#############
#S........###
###.#.....###
#...#.#.#.#.#
#.#.#.#.#.#.#
#.#.#.#.#.#.#
#.#.#.#.#.#.#
#...#......##
###.###E#####
#############
