#############
#S.......####
###.#.....###
#...#.#.#.#.#
#.#.#.#.#.#.#
#.#.#.#.#.#.#
#.#.#.#.#.#.#
#...#.....###
###.###..####
########E####
#############
