#############
#S........###
###.#......##
#...#.#.#.#.#
#.#.#.#.#.#.#
#.#.#.#.#.#.#
#.#.#.#.#.#.#
#...#......##
###.######E##
#############
